2,2,2,2,2,2,2,2,
10,10,9,14,10,11,13,14,
11,15,4,10,10,10,2,8,
10,8,2,9,15,14,10,2,
10,2,10,2,10,8,10,10,
11,15,15,13,15,6,10,10,
10,10,8,2,8,10,10,10,
8,9,4,9,5,13,13,12,
