10x10
2,1,7,7,6,2,2,2,2,2,
10,2,8,8,10,10,10,10,10,10,
11,15,6,3,13,12,10,10,11,12,
8,10,8,11,4,2,10,11,12,2,
2,10,2,10,3,12,10,10,2,10,
10,10,11,14,10,2,11,14,10,10,
10,10,8,11,13,15,12,11,13,14,
11,15,7,15,4,11,4,11,6,8,
10,10,8,10,2,9,4,10,10,2,
8,9,4,9,13,5,4,8,9,12,
